11111111111101111111111111
1E0000000000000C00000C0001
10100101001000001010010001
10100100101010100010010001
1P0000000C00C0000000000001
11111111111111110111111111
