1111111111111
10C010E010001
1000100010001
1101110111011
10000000X0001
1000X00000001
1101110111011
1000100010001
10C010C010P01
1111111111111
